////**////
/********/
/**////**/
/**////**/
/**////**/
/**////**/
/**////**/
/$//////$/
/**+**+**/
////**////