5,10
////////////////////////////
/**************************/
/**************************/
/**************************/
/********////**////********/
/********/********/********/
/********/**////**/********/
/********/**////**/********/
/********/**////**/********/
/********/**////**/********/
/********/**////**/********/
/********/$//////$/********/
/********/**+**+**/********/
/********////**////********/
/**************************/
/**************************/
/**************************/
////////////////////////////