1,1
////////////////
/****/****/****/
////*/*//*/*////
/**/*/*////*/**/
/**/********/**/
/**/*//////*/**/
/*//***//***//*/
/****/****/****/
/******//******/
/*//*//////*//*/
/**/********/**/
/**/***////*/**/
/**/*/*////*/**/
////*/*//*/*////
/****/****/****/
////////////////