1,1
////////////////////
/**//**********//**/
/*///*////////*///*/
/******************/
///*/*///*///*//*///
///*/*///*///*//*///
/***/***/*/***//***/
/*/////*/*/*//////*/
/*/////*/*/*//////*/
/*/***/***/*//***/*/
/***/***/******/***/
/*/////*/*/*//////*/
/*/////*/*/*//////*/
/***/***/*/***//***/
///*/*///*///*//*///
///*/*///*///*//*///
/******************/
/*///*////////*///*/
/**//**********//**/
////////////////////