1,1
////////////////////////
/***/**************/***/
/***/**//******//**/***/
///*****/**//**/*****///
/**********************/
///////*////////*///////
/*****/*/******/*/*****/
/*/*/*/*/*/**/*/*/*/*/*/
/*/*/*/*/*/**/*/*/*/*/*/
/*///*/*/*////*/*/*///*/
/**********************/
///*///////**///////*///
/********//**//********/
///*///////**///////*///
/**********************/
/*///*/*/*////*/*/*///*/
/*/*/*/*/*/**/*/*/*/*/*/
/*****/*/******/*/*****/
///////*////////*///////
/**********************/
///*****/**//**/*****///
/***/**//******//**/***/
/***/**************/***/
////////////////////////